111111111111111111111
1C0010CCCC000000000C1
1000000000000000C0001
1P001E100000000CCCC01
111111111111111111111
